000000000000000000000
000000000000000000000
000000000000000000000
000000000000000000000
000000000000000000000
000000000000000000000
000000000000000000000
000011111111111100000
000011411311111100000
000011111111141100000
00001113111AB11100000
000011411911CZ1100000
000011441111113100000
000011111111111100000
000011111111111100000
000000000000000000000
000000000000000000000
000000000000000000000
000000000000000000000
000000000000000000000
000000000000000000000