000000000000000000000
000000000000000000000
000000000000000000000
000000000000000000000
000000000000000000000
000000000000000000000
000011100000000000000
000019100000000000000
000011100000000000000
000000000000000000000
000000000000411200000
00041BZ11171111004000
00041A311171120044000
000411111171111004000
000000000000411200000
000000000000000000000
000000000000000000000
000000000000000000000
000000000000000000000
000000000000000000000
000000000000000000000