000000000000000000000
000000000000000000000
000000000000000000000
000000000000000000000
000000000000000000000
000000000000000000000
000000000000001111100
000000000000001464100
000000000000001696100
000000000000001464100
000000000000001111100
014441111100001111100
0421241111000031A1140
0412161111000011B3310
0421241114000011Z1110
014441111100001111110
000000000000000000000
000000000000000000000
000000000000000000000
000000000000000000000
000000000000000000000