000000000000000000000
000000000000000000000
000000000000000000000
000000000000000000000
004444411171111121100
00415Z111171111441100
0041AB111171111444100
004311511171113144100
004111111171111121100
000000000000000000000
000000000000000000000
000000000000000000000
000000000000000000000
000000000000000000000
000111000000000000000
000191000000000000000
000111000000000000000
000444000000000000000
000000000000000000000
000000000000000000000
000000000000000000000