000000000000000000000
000000000000000000000
000000000000000000000
001111111111111111110
001444444411111111110
001411111111111111410
001447444411111111310
001141411111111111110
001142410000000111110
001141410001000111110
001111110019100111310
001111110001000111110
00111A110000000111110
00111BZ11111111111110
00111CD11111111111310
001141411111111111410
001144411111111111110
001111111111111111110
000000000000000000000
000000000000000000000
000000000000000000000