000000000000000000000
000000000000000000000
000000000000000000000
000000000000000000000
000000000000000000000
000040000444000040000
000111100494001111000
000171101464101171000
000737111464111737000
000171111111111171000
000111151313151111000
0001111ZHGF1111111000
0001111111E1111111000
0001111ABCD1111111000
000111111141111111000
000000000000000000000
000000000000000000000
000000000000000000000
000000000000000000000
000000000000000000000
000000000000000000000