000000000000000000000
000000000000000000000
000000000000000000000
000000000000000000000
000004444444444100000
000041123211111400000
000004414414414100000
000000414111474000000
000000111151111000000
00000011111Z111000000
00000011119C111000000
0000001111AB111000000
000000111111111000000
000000111313111000000
000000121111111000000
000000111111111000000
000000441111144000000
000000000000000000000
000000000000000000000
000000000000000000000
000000000000000000000