000000000000000000000
000000000000000000000
000000000000000000000
000000000000000000000
000000000000000000000
000000000000000000000
000000000000000111110
000000000000000119110
000000000000000111110
000000000000000111110
001111111000011111410
001431111000011A11410
001411111000011B33410
001431111000011Z11410
001111111000011111410
000000000000000111110
000000000000000000000
000000000000000000000
000000000000000000000
000000000000000000000
000000000000000000000