000000000000000000000
000000000000000000000
006666600000314440000
0067177000001A9140000
0071117000001BCZ10000
007121700000311130000
007111700000000000000
007777700000000000000
001151100000000000000
001111100000000000000
001313100000000000000
001111100000111111000
006666600000113111000
000000000000144644000
000000000000142124000
000000000000142116000
000000000000142224000
000000000000144444000
000000000000000000000
000000000000000000000
000000000000000000000