000000000000000000000
000000000000000000000
000044444444444440000
000452115151515114000
000415251525113114000
000451515151151414000
000414444444444414000
000414111151151414000
000414177711515414000
000414179715151314000
000414177711115414000
000414444444444444000
000464000000000000000
000010000000000000000
000011000000000000000
000011000000313140000
000000000000A15100000
000600000000BCZ100000
000000000000000000000
000000000000000000000
000000000000000000000