000000000000000000000
000000000000000000000
000000000000000000000
004440444440400000000
004116111111400000000
004666441191400000000
004161114131400000000
004141114111400000000
004143114111400000000
004114441131444444000
004CBA111111111114000
004DEF166111555114000
004ZHG622615111514000
004111621615313514000
004444166115111514000
000004111111555664000
000004111111111114000
000004444444444444000
000000000000000000000
000000000000000000000
000000000000000000000