000000000000000000000
000000000000000000000
001611111111111111100
001310000011DEFGHZ100
001110000011C11111100
007770000011B15111100
007177711111A11113100
067113711111000014100
007777711000002001100
000000001000023201100
000000001000002001100
000000001000000001100
000000001111111113100
001111111111146411100
006000000000441440000
000000000000411140000
000000000000419140000
000000000000411140000
000000000000444440000
000000000000000000000
000000000000000000000