000000000000000000000
000000000000000000000
001111000000000044400
001A31000020000112400
001B1Z000030000111400
001CDE000000000111100
000000000000000000000
000000000000000000000
000000000000000000000
000000000444000000000
000000000594000133100
000110301144000000000
000110001100000000000
000110000000000000000
005111000000000151500
005111000000000515100
004111000000000522400
004400000000000144400
000000000000000000000
000000000000000000000
000000000000000000000