000000000000000000000
000000000000000000000
000000000000000000000
000000000000000000000
000000000000000000000
000000000000000000000
000111111100000000000
000111191100000000000
000111111100000000000
000143111100000111100
000141111100000124100
000143111100000111100
000111ZC1100000000000
000111AB1100000000000
000111111100000000000
000000000000000000000
000000000000000000000
000000000000000000000
000000000000000000000
000000000000000000000
000000000000000000000