000000000000000000000
000000000000000000000
000000000000000000000
000000000000000000000
000000000000000000000
000000000000000000000
000000004444400000000
000000004191400000000
000000004141400000000
000000004151400000000
011111114454411111110
0141113114541Z1111410
014121111111AB3111410
014111311121111111410
011111111111111121410
011111141111141111110
000000111111111000000
000000000000000000000
000000000000000000000
000000000000000000000
000000000000000000000