000000000000000000000
000000000000000000000
000000000000000000000
000000000000000000000
000000000000000000000
000000000000000000000
004111110000111110000
004151110000119110000
004111110000111110000
004111110000001000000
0041AB110000001000000
0041ZC510000000000000
004131110000000000600
004111110000000000000
004111110000000000000
000000000000000000000
000000000000000000000
000000000000000000000
000000000000000000000
000000000000000000000
000000000000000000000